NO	./path_to_the_north_texture.xpm
SO	./path_to_the_south_texture.xpm
WE	./path_to_the_west_texture.xpm
EA	./path_to_the_east_texture.xpm

F	220,100,0
C	225,30,0

11111111111111111111111111111
110000011101010111110111100011111
100000000001010000000111100000001
11000001110101011111011110N011111
11110111 1100001 101011010001
11111111 1111111 111111111111