NO	./images/north.xpm
SO	./images/south.xpm
WE	./images/west.xpm
EA	./images/east.xpm

F	0,42,0
C	59,89,189

11111111111111111111111111111
 10000011101010111110111100011111
  100000000001000000000111000000011
 1000001110100011111010000N011111
11111111 1111111 111111111111