NO	./path_to_the_north_texture.xpm
SO	./path_to_the_south_texture.xpm
WE	./path_to_the_west_texture.xpm
EA	./path_to_the_east_texture.xpm

F	220,100,0
C	225,30,0

11111111111111111111111111111
 10000011101010111110111100011111
  100000000001000000000111100000011
 1000001110100011111010000N011111
11111111 1111111 111111111111